//MAP CONVERTED BY dmm2tgm.py THIS HEADER COMMENT PREVENTS RECONVERSION, DO NOT REMOVE
"a" = (
/turf/wall/concrete/reinforced,
/area/template_noop)
"b" = (
/turf/floor/tiled,
/area/template_noop)
"c" = (
/obj/effect/floor_decal/borderfloor,
/obj/effect/floor_decal/corner/brown/border,
/obj/structure/closet/crate/ward{
	dir = 2
	},
/obj/item/gun/energy/lasertag/blue,
/obj/item/gun/energy/lasertag/blue,
/obj/item/gun/energy/lasertag/red,
/obj/item/gun/energy/lasertag/red,
/obj/item/clothing/suit/bluetag,
/obj/item/clothing/suit/bluetag,
/obj/item/clothing/suit/redtag,
/obj/item/clothing/suit/redtag,
/turf/floor/tiled/steel_dirty,
/area/template_noop)
"d" = (
/obj/machinery/firealarm{
	pixel_y = 24
	},
/turf/floor/tiled/steel_dirty,
/area/template_noop)
"e" = (
/turf/wall/concrete{
	can_open = 1
	},
/area/template_noop)
"f" = (
/obj/effect/floor_decal/borderfloor{
	dir = 4
	},
/obj/effect/floor_decal/corner/brown/border{
	dir = 4
	},
/obj/structure/largecrate,
/turf/floor/tiled/steel_dirty,
/area/template_noop)
"g" = (
/obj/structure/closet/crate/ummarcar,
/obj/item/toner,
/obj/item/toner,
/obj/item/toner,
/obj/item/clipboard,
/obj/item/clipboard,
/obj/item/pen/red,
/obj/item/pen/blue,
/obj/item/pen/blue,
/obj/item/camera_film,
/obj/item/folder/blue,
/obj/item/folder/red,
/obj/item/folder/yellow,
/obj/item/hand_labeler,
/obj/item/stack/tape_roll,
/obj/item/paper_bin,
/obj/item/sticky_pad/random,
/turf/floor/tiled/monotile,
/area/template_noop)
"h" = (
/obj/structure/cable/green{
	icon_state = "4-8"
	},
/obj/effect/floor_decal/steeldecal/steel_decals4{
	dir = 1
	},
/obj/effect/floor_decal/steeldecal/steel_decals4{
	dir = 6
	},
/obj/machinery/atmospherics/pipe/manifold/hidden/supply,
/obj/machinery/atmospherics/pipe/manifold/hidden/scrubbers{
	dir = 1
	},
/turf/floor/tiled,
/area/template_noop)
"i" = (
/obj/structure/closet/crate/freezer/centauri,
/obj/random/meat,
/obj/item/chems/drinks/milk,
/obj/item/chems/drinks/soymilk,
/obj/item/box/fancy/egg_box,
/turf/floor/tiled,
/area/template_noop)
"j" = (
/turf/template_noop,
/area/template_noop)
"k" = (
/obj/random/crate,
/obj/random/maintenance/cargo,
/obj/random/maintenance/cargo,
/turf/floor/tiled/monotile,
/area/template_noop)
"l" = (
/obj/effect/floor_decal/borderfloor,
/obj/effect/floor_decal/corner/brown/border,
/obj/structure/closet/crate/large/einstein,
/obj/item/cell,
/obj/item/cell,
/obj/item/cell/high,
/obj/item/cell/high,
/obj/random/powercell,
/obj/random/powercell,
/obj/machinery/alarm{
	dir = 1;
	pixel_y = -22
	},
/turf/floor/tiled/steel_dirty,
/area/template_noop)
"n" = (
/obj/structure/cable/green{
	icon_state = "1-8"
	},
/obj/machinery/atmospherics/pipe/simple/hidden/scrubbers{
	dir = 4
	},
/obj/machinery/atmospherics/pipe/simple/hidden/supply{
	dir = 4
	},
/turf/floor/tiled,
/area/template_noop)
"o" = (
/obj/random/junk,
/turf/floor/tiled/monotile,
/area/template_noop)
"p" = (
/obj/effect/floor_decal/borderfloor,
/obj/effect/floor_decal/corner/brown/border,
/obj/random/crate{
	dir = 8
	},
/obj/random/maintenance/clean,
/obj/random/maintenance/clean,
/turf/floor/tiled/steel_dirty,
/area/template_noop)
"q" = (
/obj/effect/floor_decal/borderfloor,
/obj/effect/floor_decal/corner/brown/border,
/obj/structure/closet/crate/engineering,
/obj/random/tool,
/obj/random/tool/powermaint,
/obj/random/toolbox,
/obj/random/technology_scanner,
/turf/floor/tiled/steel_dirty,
/area/template_noop)
"s" = (
/obj/effect/floor_decal/borderfloor,
/obj/effect/floor_decal/corner/brown/border,
/obj/structure/closet/crate/aether,
/obj/random/tank,
/obj/random/tank,
/obj/item/clothing/mask/breath,
/obj/item/clothing/mask/breath,
/turf/floor/tiled/steel_dirty,
/area/template_noop)
"t" = (
/turf/wall/concrete,
/area/template_noop)
"u" = (
/obj/effect/floor_decal/borderfloor{
	dir = 8
	},
/obj/effect/floor_decal/corner/brown/border{
	dir = 8
	},
/obj/machinery/light{
	dir = 8
	},
/obj/structure/closet/crate/grayson{
	dir = 1
	},
/obj/random/multiple/ore_pile,
/turf/floor/tiled/steel_dirty,
/area/template_noop)
"v" = (
/obj/structure/cable/green{
	icon_state = "0-2"
	},
/obj/item/frame/apc,
/obj/structure/closet/crate/focalpoint,
/obj/item/stock_parts/circuitboard/apc,
/obj/item/stack/cable_coil/random,
/obj/item/cell/apc,
/turf/floor/plating,
/area/template_noop)
"w" = (
/obj/random/crate{
	dir = 4
	},
/turf/floor/tiled,
/area/template_noop)
"x" = (
/obj/random/tech_supply/component/nofail,
/obj/random/tech_supply/component/nofail,
/obj/random/tech_supply/component,
/obj/random/tech_supply/component,
/obj/random/tech_supply/component,
/obj/random/tech_supply/component,
/obj/random/tech_supply/component,
/obj/random/tech_supply/component,
/obj/structure/closet/crate/large/secure/xion,
/obj/machinery/atmospherics/unary/vent_pump{
	dir = 1
	},
/turf/floor/tiled,
/area/template_noop)
"y" = (
/obj/effect/floor_decal/corner_steel_grid{
	dir = 5
	},
/obj/effect/floor_decal/steeldecal/steel_decals5,
/obj/effect/floor_decal/steeldecal/steel_decals_central4,
/obj/effect/floor_decal/spline/plain,
/obj/machinery/floodlight,
/obj/effect/decal/cleanable/cobweb2,
/turf/floor/tiled,
/area/template_noop)
"z" = (
/obj/random/obstruction,
/turf/floor/plating,
/area/template_noop)
"A" = (
/obj/effect/floor_decal/borderfloor{
	dir = 6
	},
/obj/effect/floor_decal/corner/brown/border{
	dir = 6
	},
/obj/structure/closet/crate/nanomed{
	dir = 2
	},
/obj/random/medical,
/obj/random/medical/lite,
/obj/random/medical/lite,
/turf/floor/tiled/steel_dirty,
/area/template_noop)
"C" = (
/obj/machinery/atmospherics/pipe/simple/hidden/supply,
/turf/floor/tiled,
/area/template_noop)
"D" = (
/obj/structure/closet/crate/thinktronic,
/obj/item/modular_computer/pda,
/obj/item/modular_computer/pda,
/obj/item/modular_computer/pda,
/turf/floor/tiled/monotile,
/area/template_noop)
"E" = (
/obj/effect/floor_decal/borderfloor/corner{
	dir = 1
	},
/obj/effect/floor_decal/corner/brown/bordercorner{
	dir = 1
	},
/obj/structure/ore_box,
/obj/machinery/atmospherics/unary/vent_pump,
/turf/floor/tiled/steel_dirty,
/area/template_noop)
"F" = (
/obj/machinery/atmospherics/pipe/simple/hidden/scrubbers{
	dir = 9
	},
/obj/machinery/atmospherics/pipe/simple/hidden/supply{
	dir = 10
	},
/turf/floor/tiled,
/area/template_noop)
"G" = (
/obj/effect/floor_decal/borderfloor{
	dir = 8
	},
/obj/effect/floor_decal/corner/brown/border{
	dir = 8
	},
/obj/structure/loot_pile/maint/boxfort,
/turf/floor/tiled/steel_dirty,
/area/template_noop)
"H" = (
/obj/effect/floor_decal/borderfloor{
	dir = 10
	},
/obj/effect/floor_decal/corner/brown/border{
	dir = 10
	},
/obj/structure/largecrate,
/turf/floor/tiled/steel_dirty,
/area/template_noop)
"I" = (
/obj/effect/floor_decal/borderfloor{
	dir = 8
	},
/obj/effect/floor_decal/corner/brown/border{
	dir = 8
	},
/obj/structure/ore_box,
/turf/floor/tiled/steel_dirty,
/area/template_noop)
"J" = (
/obj/structure/cable/green{
	icon_state = "4-8"
	},
/obj/machinery/atmospherics/pipe/simple/hidden/scrubbers{
	dir = 4
	},
/obj/machinery/atmospherics/pipe/simple/hidden/supply{
	dir = 4
	},
/turf/floor/tiled,
/area/template_noop)
"K" = (
/obj/random/crate,
/obj/random/maintenance/clean,
/obj/random/maintenance/clean,
/obj/random/maintenance/clean,
/obj/machinery/atmospherics/pipe/simple/hidden/scrubbers,
/turf/floor/tiled,
/area/template_noop)
"L" = (
/obj/machinery/atmospherics/pipe/cap/hidden/scrubbers{
	dir = 4
	},
/obj/machinery/atmospherics/pipe/cap/hidden/supply{
	dir = 4
	},
/turf/wall/concrete{
	can_open = 1
	},
/area/template_noop)
"M" = (
/obj/machinery/atmospherics/pipe/simple/hidden/scrubbers,
/turf/floor/tiled,
/area/template_noop)
"N" = (
/obj/effect/floor_decal/borderfloor/corner{
	dir = 1
	},
/obj/effect/floor_decal/corner/brown/bordercorner{
	dir = 1
	},
/obj/structure/reagent_dispensers/fueltank,
/turf/floor/tiled,
/area/template_noop)
"O" = (
/obj/effect/floor_decal/borderfloor/corner{
	dir = 4
	},
/obj/effect/floor_decal/corner/brown/bordercorner{
	dir = 4
	},
/obj/item/stack/tile/floor,
/obj/machinery/light/fixture{
	dir = 1
	},
/turf/floor/tiled,
/area/template_noop)
"P" = (
/obj/effect/floor_decal/borderfloor,
/obj/effect/floor_decal/corner/brown/border,
/obj/structure/closet/crate/allico,
/obj/random/plushie,
/obj/random/plushie,
/obj/random/plushie,
/obj/random/toy,
/obj/random/toy,
/obj/random/toy,
/turf/floor/tiled/steel_dirty,
/area/template_noop)
"Q" = (
/obj/structure/closet/crate/nanothreads,
/obj/random/thermalponcho,
/obj/item/umbrella/random,
/obj/item/umbrella/random,
/obj/item/towel/random,
/obj/item/towel/random,
/obj/item/towel/random,
/obj/random/maintenance/clean,
/obj/machinery/atmospherics/unary/vent_scrubber{
	dir = 1
	},
/turf/floor/tiled,
/area/template_noop)
"S" = (
/obj/effect/floor_decal/steeldecal/steel_decals4{
	dir = 9
	},
/obj/effect/floor_decal/steeldecal/steel_decals4{
	dir = 4
	},
/turf/floor/tiled,
/area/template_noop)
"U" = (
/obj/structure/grille,
/obj/structure/window/reinforced/full,
/obj/machinery/status_display/supply_display,
/turf/floor/plating,
/area/template_noop)
"V" = (
/obj/machinery/atmospherics/pipe/simple/hidden/scrubbers{
	dir = 4
	},
/obj/machinery/atmospherics/pipe/simple/hidden/supply{
	dir = 4
	},
/turf/floor/tiled,
/area/template_noop)
"W" = (
/obj/machinery/atmospherics/unary/vent_scrubber,
/turf/floor/tiled,
/area/template_noop)
"X" = (
/obj/effect/floor_decal/borderfloor{
	dir = 4
	},
/obj/effect/floor_decal/corner/brown/border{
	dir = 4
	},
/obj/machinery/light{
	dir = 4
	},
/obj/structure/closet/crate/unathi,
/obj/item/food/unajerky,
/obj/item/food/unajerky,
/obj/item/food/unajerky,
/obj/item/food/unajerky,
/obj/item/food/unajerky,
/obj/item/food/unajerky,
/obj/item/food/unajerky,
/obj/item/food/unajerky,
/turf/floor/tiled/steel_dirty,
/area/template_noop)
"Y" = (
/turf/floor/tiled/monotile,
/area/template_noop)

(1,1,1) = {"
t
t
j
j
a
a
a
a
a
"}
(2,1,1) = {"
a
a
a
L
a
I
u
H
a
"}
(3,1,1) = {"
j
a
E
h
K
M
Q
P
a
"}
(4,1,1) = {"
j
e
S
J
Y
Y
b
c
a
"}
(5,1,1) = {"
j
a
O
J
D
o
b
l
a
"}
(6,1,1) = {"
a
a
v
n
g
Y
w
p
a
"}
(7,1,1) = {"
a
G
N
V
k
Y
i
q
a
"}
(8,1,1) = {"
a
d
W
F
C
C
x
s
a
"}
(9,1,1) = {"
a
y
z
z
U
f
X
A
a
"}
(10,1,1) = {"
a
a
a
a
a
a
a
a
a
"}
